1111111111
1P00000001
10C00000C1
11111100C1
11001100C1
1000100EC1
1000000001
1C1100C0C1
1C010000C1


1111111111