1111111111
1000000001
10C00000C1
10001100C1
10001100C1
10000000C1
1001000001
1001E0C0C1
1P01E000C1
1111111111