1111111111
1000000001
10C00000C1
10001100C1
10001100C1
10000000C1
1001000001
101100C111
1P01001E01
1111111111
