11111111111111111111111111111111111
1P000000000000000000000000000000001
10001000100001000010000100001000EC1
10000000000000000000000000000000001
1C11001100C1100C1100C1100C1100CC0C1
11111111111111111111111111111111111