1111111111
1000000001
10c00000c1
10001100c1
10001100c1
10000000c1
1001000001
100100c0c1
1P01E000c1
1111111111
