NO textures/ground.xpm
SO textures/lava.xpm
WE textures/green.xpm
EA textures/pocketmon_front.xpm
F 0,200,0
C 0,30,254

111111111111111111111111111111111111111111111111111111111111111111111111111111111111111111111111111111111111111111111111111111111111111111111111
1E0000000000000000000000000000000000000000000000000000000000000000000000000000000000000000000000000000000000000000000000000000000000000000000001
111111111111111111111111111111111111111111111111111111111111111111111111111111111111111111111111111111111111111111111111111111111111111111111111
